20
20
1 1 1 1 The Beginning
WWWWWWWWWWWWWWWWWWWW
WCCCCCCCCCCCCCCCCCCW
WCWWWWWWCWWCWWWWWWCW
WCCCCCWCCWWCCWCCCCCW
WWWCWCWCWWWWCWCWCWWW
WWWCWCWCWWWWCWCWCWWW
WACCWCCCCCCC0CCWCCPW
WCWWWCWWCWWC2WCWWWCW
W000CC00000000CCCCCW
WWWWWC0LQEEQL0CWWWWW
WWWWWC0LLLLLL0CWWWWW
WCCCCC00000000CC0005
WCWWWCWWCWWCWWCWWWCW
WPCCWCCCCSCCCCCWCCFW
WWWCWCWCWWWWCWCWTWWW
WWWCWCWCWWWWCWCWCWWW
WCCCCCWCCWWCCWCCCCCW
WCWWWWWWCWWCWWWWWWCW
WCCCCCCCCCCCCCCCCCCW
WWWWWWWWWWWWWWWWWWWW
800 2100
800 3000