13
13
60 90
1 1 2 2 Vulcano
WWWWWWWWWWWWW
WA0CCXWCMCCCW
W00CCvWvCWWCW
W00CC0WCFWWCW
W00CC01CCWWCW
L0CCV100PCCrL
LLLL0000LLLLL
LCCS0000CCCrL
LCWW0000CWWCL
WCCWCCLCCWPCW
W0WWW0LCWWWWW
WCCPCCCC0CBCW
WWWWWWWWWWWWW
1000 2500