7
6
30 60
1 1 1 1 Tutorial 1
WWWWWWW
WCCCCAW
WCWWWCW
WCCCCCW
WCWSWCW
WWWWWWW
