20
20
130 150
6 1 1 1 Going deeper
WWWWWWWWV200WWWWWWWW
WvCWACCC0000CCCFWCgW
WCCWCCWW0000WWCCWCCW
WCCCCCCL0000LCCCCCCW
WCWWWWCLWCCWLCWWWW0W
WCCWPCCCWCCWCCCPWCCW
WyCCCLLCCCCCCLLCCCyW
WCCWWWWWWWWWWWWWWCCW
WCCCCCCWEEEEWCCCCCCW
V100TCCW0000WCCHV300
0000WCCWCCCCWWCW0000
0000WCCCCWWCCCCW0000
0000CCLLCCCCLLCC0000
WrCCCWWWWWWWWWWCCCrW
WCCPCCCCWSCWCCCCPCCW
WWCWWCCCCCCCCCCWWCWW
WCCCWCWWWCCWWWCWCCCW
WCCCWCCCWCCWCCCWCCCW
WvCFWLCCCCCCCCLWACgW
WWWWWWWWWWWWWWWWWWWW
