8
9
10 17
5 1 1 2 Race
WWWWWWWW
WRCCCCCW
WWWWWWCW
WCCCCCCW
WCWWWWFW
WCCCCCCW
WWWWWWCW
WSCCCCCW
WWWWWWWW