20
20
5 1 Gauntlet
WWWWWWWWWWWWWWWWWWWW
WL4Z20LLLLLLLLLLCCRW
WLL000LLECCCLLCCCWLW
WLL000CCCLLCCCPWWLLW
WLCCCCCWWLLWWWWLZ30W
WLCAWWWCCCCWWLLL000W
WLCCCCCCWWCCCWWL000W
WWWWWWWWWWWWCCWWLLLW
WLWCCCPWCCCCWCCWWLLW
WLWCWWCCCWrCWWCCCWLW
WLWCCCWWCrWCCCWWCWLW
WLLWWCCWCCCCWPCCCWLW
WLLLWWCCWWWWWWWWWWWW
WZ10LWWCCCWWCCCCCCLW
W000LLLWWCCCCWWWACLW
W000LWWWWLLWWCCCCCLW
WLLWWPCCCLLCCCZ40LLW
WLWCCCLLCCCELL000LLW
WSCCLLLLLLLLLL0002LW
WWWWWWWWWWWWWWWWWWWW
5000 6500
5000 6500