20
20
2 2 Gargoyle lair
WWWWWWWWWWWWWWWWWWWW
W0CCEWCCCCPCCCCWCCMW
WCCCCWCWWWWWWWCWWWCW
WCCCCWCCCCCCCCCWCFCW
WFCC0WCCWC4CW0WWCWCW
WWWWCWCCWC0CWXWWCWCW
W30C0WWW4W0WWWWWCWCW
WWC01WW00CC001CCCC0W
WW0C0010CJ2C0W0WWWCW
WWLLLC0CC00C0CCCPWCW
WWLLLWW0C00C0WCWCCCW
WCCCCRWCP00C0WCWWWCW
WCWWWCWB0CC0CWCWCC0W
WCWCCCWWWWW2W3CCCWWW
WCWCWCCCCCCCCCCWCCWW
WCCCWCCWWCCWWCCWCCWW
WCCWWWCFWCCWPCWWWCCW
WCCCWSCWWCCWWCCWCCCW
WCWCCCCCgWWgCCCCCWEW
WWWWWWWWWWWWWWWWWWWW
2800 3800
1700 2700
1700 2900
900 1900
2950 4200
1600 2900
1700 2900
800 2000