21
21
2 1 Mirror
WWWWWWWWWWWWWWWWWWWWW
WPC00C0300X0010C00CFW
W0WWWWWC0L0L0CWWWWW0W
WCWWE0CC0LLL0CC0MWWCW
WCWWCQWC0LLL0CWQCWWCW
WCWWWWWC0LLL0CWWWWWCW
W0B0CCCC05070CCCC0B0W
W0WWCCWWWWWWWWWCCWW0W
W0WWC0WrWCPCWvWC0WW0W
WC0C01WCWC4CWCW30C0CW
WCWWWWWCCC0CCCWWWWWCW
WCC0C0C01W0W30C0C0CCW
WW0CJ2C0CW0WC0CJ2C0WW
WWC000CCFW0WACC000CWW
WW0C00CWWW0WWWC00C0WW
WCC000CCgW0WgCC000CCW
WWWWWWWCCW0WCCWWWWWWW
WA0CCCWBrW0WvPWCCC0PW
WAW0CCWWWW0WWWWCC0WWW
WWWE0CCCCC0CCCCC0SWWW
WWWWWWWWWWWWWWWWWWWWW
1100 2100
1100 2100
1050 2200
1050 2200
1000 2000
2900 4650
1000 2000
1150 3200
1150 3200
