9
9
30 60
2 1 2 2 There are no walls
WWWWWWWWW
WCFCCCQCW
WWWWWWWWW
W0T0WX00W
W000W00KW
W0S0WWWWW
W0P0000HW
WACCCCCFW
WWWWWWWWW
