9
9
1 1 Portals
WWWWWW0CW
WCCCWWWCW
WrWCCCCCW
WWWWWWW2W
Wr7CCCCCW
WCWCWWCgW
WCWWgWWWW
WCCCCCCSW
WWWWWWWWW
1500 2700
1400 3100