9
9
30 60
1 1 2 1 Tutorial 2
WWWWWWWWW
WFCCCCCCW
WCWWPWWWW
WCECCCCCW
WWWWWW0WW
W0S0WWC0W
W0P0WWWCW
W0CCCCCCW
WWWWWWWWW
