10
8
1 1 2 Main screen
WWWWWWWWWW
WgP0CC0F0W
WCLCE0CLCW
W0LLLLLL0W
WC0L00L0C1
WWWLWWLWWW
WCC0S00CC0
WWWWWWWWWg
800 3000
